{
    "type": "raycast3D",
    "textures":{
        "1": "texture@pyk::raycaster.mine::chised_stone_bricks",
        "2": "texture@pyk::raycaster.mine::stone_bricks",
        "3": "texture@pyk::raycaster.mine::andesite",
        "4": "texture@pyk::raycaster.mine::red_smooth_sandstone_side",
        "5": "texture@pyk::raycaster.mine::bordered_cobblestone",
        "6": "texture@pyk::raycaster.mine::red_smooth_chised_sandstone",
        "7": "texture@pyk::raycaster.mine::stone",
        "8": "texture@pyk::raycaster.mine::smooth_andesite",

        "9": "texture@pyk::raycaster.mine::oak_door",
        "10": "texture@pyk::raycaster.mine::pine_door",
        "11": "texture@pyk::raycaster.mine::dark_oak_door",
        "12": "texture@pyk::raycaster.mine::iron_door",

        "13": "texture@pyk::raycaster.mine::oak_planks",
        "14": "texture@pyk::raycaster.mine::pine_planks",
        "15": "texture@pyk::raycaster.mine::dark_oak_planks",

        "16": "texture@pyk::raycaster.dave.standart",
        "17": "texture@pyk::raycaster.dave.green",
        "18": "texture@pyk::raycaster.dave.gray",
        "19": "texture@pyk::raycaster.dave.yellow",
        "20": "texture@pyk::raycaster.dave.skin",
        "21": "texture@pyk::raycaster.dave.pink",
        "22": "texture@pyk::raycaster.dave.blue",
        "23": "texture@pyk::raycaster.kaizer",

        "floorDefaultTex1":"texture@pyk::raycaster.mine::smooth_andesite",
        "floorDefaultTex2":"texture@pyk::raycaster.mine::smooth_stone",
        "ceilDefaultTex":"texture@pyk::raycaster.mine::pine_planks"
    },
    "entities": [
        {
            "prefab": "entity@pykinst::raycasterplayer",
            "positions": [[22, 11.5]]
        }
    ],
    "map":{
        "grid": [
            [8,8,8,8,8,8,8,8,8,8,8,4,4,6,4,4,6,4,6,4,4,4,6,4],
            [8,0,0,0,0,0,0,0,0,0,8,4,0,0,0,0,0,0,0,0,0,0,0,4],
            [8,0,3,3,0,0,0,0,0,8,8,4,0,0,0,0,0,0,0,0,0,0,0,6],
            [8,0,0,3,0,0,0,0,0,0,0,0,0,0,0,0,0,0,0,0,0,0,0,6],
            [8,0,3,3,0,0,0,0,0,8,8,4,0,0,0,0,0,0,0,0,0,0,0,4],
            [8,0,0,0,0,0,0,0,0,0,8,4,0,0,0,0,0,6,6,6,0,6,4,6],
            [8,8,8,8,0,8,8,8,8,8,8,4,4,4,4,4,4,6,0,0,0,0,0,6],
            [7,7,7,7,0,7,7,7,7,0,8,0,8,0,8,0,8,4,0,4,0,6,0,6],
            [7,7,0,0,0,0,0,0,7,8,0,8,0,8,0,8,8,6,0,0,0,0,0,6],
            [7,0,0,0,0,0,0,0,0,0,0,0,0,0,0,0,8,6,0,0,0,0,0,4],
            [7,0,0,0,0,0,0,0,0,0,0,0,0,0,0,0,8,6,0,6,0,6,0,6],
            [7,7,0,0,0,0,0,0,7,8,0,8,0,8,0,8,8,6,4,6,0,6,6,6],
            [7,7,7,7,0,7,7,7,7,8,8,4,0,6,8,4,8,3,3,3,0,3,3,3],
            [2,2,2,2,0,2,2,2,2,4,6,4,0,0,6,0,6,3,0,0,0,0,0,3],
            [2,2,0,0,0,0,0,2,2,4,0,0,0,0,0,0,4,3,0,0,0,0,0,3],
            [2,0,0,0,0,0,0,0,2,4,0,0,0,0,0,0,4,3,0,0,0,0,0,3],
            [1,0,0,0,0,0,0,0,1,4,4,4,4,4,6,0,6,3,3,0,0,0,3,3],
            [2,0,0,0,0,0,0,0,2,2,2,1,2,2,2,6,6,0,0,5,0,5,0,5],
            [2,2,0,0,0,0,0,2,2,2,0,0,0,2,2,0,5,0,5,0,0,0,5,5],
            [2,0,0,0,0,0,0,0,2,0,0,0,0,0,2,5,0,5,0,5,0,5,0,5],
            [1,0,0,0,0,0,0,0,0,0,0,0,0,0,0,0,0,0,0,0,0,0,0,5],
            [2,0,0,0,0,0,0,0,2,0,0,0,0,0,2,5,0,5,0,5,0,5,0,5],
            [2,2,0,0,0,0,0,2,2,2,0,0,0,2,2,0,5,0,5,0,0,0,5,5],
            [2,2,2,2,1,2,2,2,2,2,2,1,2,2,2,5,5,5,5,5,5,5,5,5]
        ],
        "floor_grid": [
            [8,8,8,8,8,8,8,8,8,8,8,4,4,6,4,4,6,4,6,4,4,4,6,4],
            [8,1,1,1,1,1,1,1,1,1,8,4,1,1,1,1,1,1,1,1,1,1,1,4],
            [8,1,3,3,1,1,1,1,1,8,8,4,1,1,1,1,1,1,1,1,1,1,1,6],
            [8,2,2,3,2,2,2,2,2,2,2,2,2,2,2,2,2,2,2,2,2,2,2,6],
            [8,3,3,3,3,3,3,3,3,8,8,4,3,3,3,3,3,3,3,3,3,3,3,4],
            [8,3,3,3,3,3,3,3,3,3,8,4,3,3,3,3,3,6,6,6,3,6,4,6],
            [8,8,8,8,3,8,8,8,8,8,8,4,4,4,4,4,4,6,3,3,3,3,3,6],
            [7,7,7,7,0,7,7,7,7,0,8,0,8,0,8,0,8,4,0,4,0,6,0,6],
            [7,7,0,0,0,0,0,0,7,8,0,8,0,8,0,8,8,6,0,0,0,0,0,6],
            [7,5,5,5,5,5,5,5,5,5,5,5,5,5,5,5,8,6,5,5,5,5,5,4],
            [7,5,5,5,5,5,5,5,5,5,5,5,5,5,5,5,8,6,5,6,5,6,5,6],
            [7,7,5,5,5,5,5,5,7,8,5,8,5,8,5,8,8,6,4,6,5,6,6,6],
            [7,7,7,7,5,7,7,7,7,8,8,4,5,6,8,4,8,3,3,3,5,3,3,3],
            [2,2,2,2,5,2,2,2,2,4,6,4,5,5,6,5,6,3,5,5,5,5,5,3],
            [2,2,5,5,5,5,5,2,2,4,5,5,5,5,5,5,4,3,5,5,5,5,5,3],
            [2,5,5,5,5,5,5,5,2,4,5,5,5,5,5,5,4,3,5,5,5,5,5,3],
            [1,5,5,5,5,5,5,5,1,4,4,4,4,4,6,5,6,3,3,5,5,5,3,3],
            [2,5,5,5,5,5,5,5,2,2,2,1,2,2,2,6,6,5,5,5,5,5,5,5],
            [2,2,5,5,0,0,0,2,2,2,0,0,0,2,2,0,5,0,5,0,0,0,5,5],
            [2,0,0,0,0,0,0,0,2,0,0,0,0,0,2,5,0,5,0,5,0,5,0,5],
            [1,0,0,0,0,0,0,0,0,0,0,0,0,0,0,0,0,0,0,0,0,0,0,5],
            [2,0,0,0,0,0,0,0,2,0,0,0,0,0,2,5,0,5,0,5,0,5,0,5],
            [2,2,0,0,0,0,0,2,2,2,0,0,0,2,2,0,5,0,5,0,0,0,5,5],
            [2,2,2,2,1,2,2,2,2,2,2,1,2,2,2,5,5,5,5,5,5,5,5,5]
        ],
        "ceil_grid": [
            [8,8,8,8,8,8,8,8,8,8,8,4,4,6,4,4,6,4,6,4,4,4,6,4],
            [8,1,1,1,1,1,1,1,1,1,8,4,1,1,1,1,1,1,1,1,1,1,1,4],
            [8,1,3,3,1,1,1,1,1,8,8,4,1,1,1,1,1,1,1,1,1,1,1,6],
            [8,2,2,3,2,2,2,2,2,2,2,2,2,2,2,2,2,2,2,2,2,2,2,6],
            [8,3,3,3,3,3,3,3,3,8,8,4,3,3,3,3,3,3,3,3,3,3,3,4],
            [8,3,3,3,3,3,3,3,3,3,8,4,3,3,3,3,3,6,6,6,3,6,4,6],
            [8,8,8,8,3,8,8,8,8,8,8,4,4,4,4,4,4,6,3,3,3,3,3,6],
            [7,7,7,7,0,7,7,7,7,0,8,0,8,0,8,0,8,4,0,4,0,6,0,6],
            [7,7,0,0,0,0,0,0,7,8,0,8,0,8,0,8,8,6,0,0,0,0,0,6],
            [7,5,5,5,5,5,5,5,5,5,5,5,5,5,5,5,8,6,5,5,5,5,5,4],
            [7,5,5,5,5,5,5,5,5,5,5,5,5,5,5,5,8,6,5,6,5,6,5,6],
            [7,7,5,5,5,5,5,5,7,8,5,8,5,8,5,8,8,6,4,6,5,6,6,6],
            [7,7,7,7,5,7,7,7,7,8,8,4,5,6,8,4,8,3,3,3,5,3,3,3],
            [2,2,2,2,5,2,2,2,2,4,6,4,5,5,6,5,6,3,5,5,5,5,5,3],
            [2,2,5,5,5,5,5,2,2,4,5,5,5,5,5,5,4,3,5,5,5,5,5,3],
            [2,5,5,5,5,5,5,5,2,4,5,5,5,5,5,5,4,3,5,5,5,5,5,3],
            [1,5,5,5,5,5,5,5,1,4,4,4,4,4,6,5,6,3,3,5,5,5,3,3],
            [2,5,5,5,5,5,5,5,2,2,2,1,2,2,2,6,6,5,5,5,5,5,5,5],
            [2,2,5,5,0,0,0,2,2,2,0,0,0,2,2,0,5,0,5,0,0,0,5,5],
            [2,0,0,0,0,0,0,0,2,0,0,0,0,0,2,5,0,5,0,5,0,5,0,5],
            [1,0,0,0,0,0,0,0,0,0,0,0,0,0,0,0,0,0,0,0,0,0,0,5],
            [2,0,0,0,0,0,0,0,2,0,0,0,0,0,2,5,0,5,0,5,0,5,0,5],
            [2,2,0,0,0,0,0,2,2,2,0,0,0,2,2,0,5,0,5,0,0,0,5,5],
            [2,2,2,2,1,2,2,2,2,2,2,1,2,2,2,5,5,5,5,5,5,5,5,5]
        ],
        "thin_walls": [
            [5.0, 7.0, 1, 1, 8, 1]
        ],
        "doorsMap": [
            [5.5, 5.5, 0, 0.8, 9, 0.0, 1.5, 0, 1, 13],  
            [3.5, 5.0, 1, 0.8, 10, 0.0, 1.5, 0, 1, 14],  
            [3.5, 6.5, 1, 1, 11, 0.0, 1.5, 0, 1, 15]
        ],
        "sprites": [
            [19.5, 9.5, 16, 1, 0, 0],
            [19.5, 10.5, 17, 1, 0, 0],
            [19.5, 11.5, 18, 0.5, 0.3, 0],
            [19.5, 12.5, 19, 0.5, -0.28, 0],
            [19.5, 13.5, 20, 1, 0, 0],
            [22.5, 10.5, 21, 1, 0, 0],
            [22.5, 11.5, 22, 1, 0, 0],
            [22.5, 12.5, 23, 1, 0, 0]
        ]
    }
}

